11111111111111111
10P00000000001001
10000001C00001C01
10000000000001101
10000000000000001
100000000E0000001
11111111111111111
