1111111111111111111
1000100000000000001
10E0100000C000C0001
100010000000C000001
1000000000C00000P01
1111111111111111111
