111111111111111111111111111111
100P0CCCCCCCCCCCCCCCCCCCCCCCE1
111111111111111111111111111111
