111111111111111111
1E10P00100C10000C1
101001010101001001
100010010101C01001
100100010101111001
1000C0000100000001
111111111111111111
