111111111111111111
1000000000000000P1
100000000500000001
1E0000000000000001
1CCCCCCCCCCCCCCCC1
111111111111111111
