11111111111111111111111111111111111
10000000000000000000000000000000001
100000000000000E0000000000000000001
100000000000000E00000000000P0000001
100000000000000000000000000C000C001
100000000000000000000000000000000C1
11111111111111111111111111111111111
