1111111111111111111111
1000000000000000010P01
1000000000000000010001
1000000000000E00011111
1000000000000C00000001
1111111111111111111111
