1111111111111
1 00000000001
1PEC000000001
1111111111111
