1111111111111111
1000000000000001
1E00000000000001
1P0000000000C01
1111111111111111
