1111111
0000000
EPC0000
1111111
