11111111111111111
1ECCCCCCCCCCCCCC1
11111111111111111
